11111
1P001
10CE1
10001
11111
