11111111111111
1P001000000001
10C01000000E01
10001000000001
11111111111111
