1111111111
1000000001
1P00000CE1
1000000001
1111111110
