1111111111
1000000001
1P00000C01
1000000001
1111111111
