1111111111
100000C001
1P0C000CE1
1000000001
1111111111
