1111111111
1000C01001
10P1101CE1
1C01C00001
1C01C00001
1C01C00001
1C01C00001
1C01C00001
1111111111
