111111
1P00CE1
100011111
111111
